PM0W0M0MWM
0MWM0WW0WW
0MWMMM00M0
MMM00W000W
M0WW000WWW
WWMMM00W0W
WMMMMM00MM
W000W0WM0W
M000MMFM0W
