PMWM0M0WW
WW00M0W00
MW000F00W
0MWW0M0MW
00MWM0M00
WMW0WM0MW
