WMPFM0WM
00W00WWW
M0MM00WW
W0MM00MM
WMWM0MM0
MWWM00MM
