WWPMM00WM
W0MWWMWM0
00F000WMW
MMMM0MMW0
MW00WWMWW
00MWWMW0W
0W0MM00WM
W0WMM0WMM
