0PWMW00MM
MMWMW0MWM
WW00W0000
0WMWWWMWW
MMMMF0MMW
WWMMWWMM0
W0MMM0MM0
M0M0W0MWW
WMW00WMWM
0MW0MWWMW
