MM0PW00MM
00MMW0MWM
WW00WMW0M
M00W00W0W
M0WW0W00W
00WMWMMM0
0M0W00MFM
