P0M0F00WM
0WMW0WWWW
WMWMMWMMW
0M0M0W0MW
WMW0MM000
00WW000M0
0W0W00M0M
00WM0MMWW
