WWFMM0WP00
0MMM00WWWW
MW0WWWMMMM
MWMM00M00M
WMMMWWM0WW
