W0PWM00W
MMWMM0WW
WMM0MWMM
MMMW0WWM
00M00W0M
W0M0M0M0
WMWFW0MW
M000M0M0
WW0M0WWM
MWWW0MWM
