MPW000MM
W000WMW0
MMWWWMW0
WW0MMWMM
00WM0WWW
MFMMWM00
WM00WM0W
