MWW0MM0WP
WW0M0000M
0WWWFWW0M
MWMMWWMWW
M0W0WW000
MWMMM0W0W
W0WM000MM
