W00MPW000
0MM000000
W0W0WM0WM
0WW0MMM0M
M00WFMWW0
W00WWWWWM
000M00WM0
