MWWPM0M0
WWWMWWWM
MWMW0WWM
W0WWF0M0
WMMM00M0
WMW00MW0
M0M0W0MM
00MW0WM0
MWMM000W
