PWWMWM0MW
W00MWWWW0
MM0MMW0WM
WWWW0W0WM
M0MW0W0WM
WMW0WWMMM
00MWW00M0
W0FWWMMW0
0WW0WMWMM
