MM0P0M0M
M0000MWW
MM0W0MMW
00WMF0WW
M00MW0MW
WMWW0WMM
WW0M0WMM
MW0MWWW0
WMM0MMWM
M00M0M0M
