W0WW0PWM0W
M0M0WMMWW0
0M0MM0WWM0
WMMW0000WW
WM00MWWWWF
WWW00MMM00
M0WW0WMW0W
MM0WW0MM00
0WWWMWW0WM
0W00M0MMW0
