M0MP0MM0WM
FWWWMW0WW0
00M0MW00W0
WMM0WMWW0M
MWMM0W00W0
