FWWWMWPM
WWMW00WM
0M0MMMMW
0WW0WMM0
W00M0MWM
0MW00MM0
W0WM0M0M
MWMMMM0W
WWMWM0WM
0MM00WWW
