0MMW00MWWW
0MF0MMWWWM
P0MW00W0MW
MWW0MM00W0
0000W00MMW
