WWMMW00WW
MMM00WWWP
WWFW00MMW
0000MM0MM
0MW00MWWW
0WWMMWW0W
