PM0000MM
WM000M00
W0M0M0MM
W0W0MWWW
MWW000M0
WMM0FMW0
MW0000W0
M0WM0M00
