PFM0WWM0M
WWMWWM00W
M00MMW0M0
0MMW0WWMM
WWM0MWM0M
0MWWWWWM0
W0WM00WMM
0M00MM00W
MMM0WMMW0
0MW0MMWW0
