0P00WW0MMW
WMM00M00M0
00W0WMMWM0
F00WWWW0W0
MM0M0WWW0M
