PW0MWMM0
MM0MWW0M
0000WM0W
WM0MW0MM
000MW00W
WW00MWWF
