P00M00M0
0WM0WMWW
WMWW0WW0
0MWW00WM
0W0W0WMM
00WMWWM0
MM0000FW
