M0WW000WM0
0WPW0WWW00
0WW0MWM0MW
0WMMMMWMM0
MWMWM0MM0M
W000WMWMMM
0WW00MW0W0
WWM0MWM0WW
WW0W0MMWWW
W0M0W0MF00
