MWWW0PM0W0
0MMW00W0MM
W0WM0MM0WM
W0MMWM0WW0
W0M00MWM00
M0W0W0F0M0
0WMWMMMM0M
MWWMM0W00W
